######################################################################
#S   # #   #   #    #  #     #    ####            # #  #       #     #
## # # # #   #   ##   #  ###  # #  ##  ## ## # ###    #  ## ##  # # ##
# #  #   #### # # ###   ##  # #  ##   ###  #  #    ##   #   # # # #  #
#   ## ##   # # #    # #   ##  #  # ## #  #  #  # #  ###  ##    #  # #
# ##     # #  # # # # ## ##   #  #  #  # #  #  # #  #    #   ######  #
#  ### #     #  # # #     # ## # # ### #  ##  #    #  ###  #    #   ##
##    #########   # # # ###  #   # ##   #  # # ###  #    ##  ##   #  #
# ###  #     #  ##  ###    #  # #    ##  #   #    #  ###   ##  ##### #
#   ##   ### # #  #    # # # #  # ## #  #  #### #  #    ##   # #  #  #
# #   ## #   # # # ###  ## # ##    #   # #   #   # ## #   ## #   ## ##
#  ##  ##  ##    #    # #  #   # #  ###   ## ### #   #  # #   # #    #
## #  #   #  ####  ##   # # ##  #  #    #  #   # # #   #   ## # # ## #
#  # #  ### #    #   # ##   # # # #  # # #  ##   #  #######   #   # ##
# # #  ##     ##  # # #   #   # # # # #   #   ## E##   #    ##  # #  #
#    #    ####  # #    ### ## # ##      # # # #  #   #   ###  ##   # #
# ##  # # #   # # # ## #      #   ## # #   #   # # ## # #    #   ##  #
#   #  # #  # #    ##  # ##### ##   # ## ##  # ##  #   #  # ## ##   ##
# #  #     #    ##    #           #      #  #     #  #   #        #  #
######################################################################